##########
#. .  $ .#
# $$  $@ #
###. #####
``#  #````
``####````