########
#    *.#
#  $ $@#
# $#####
#..#````
####````