``####``
``#  #``
### .###
#   $$ #
#.   $+#
########