##########
#     .*+#
#  $ $ $ #
# $#######
#..#``````
####``````